111111111111111
100000C00011001
1010P000C010001
101000000000C01
111111111111111
