11111111111111111111111
1C000000000000100000001
1000000000000000000C001
1101110000111100C000001
1E000000001111000001001
11111111010111000000001
1000000000000100000P001
10C00000000001100000001
11011100C01111C1000C001
10000000000100011000001
11111110111101111100001
1C000000000000100000001
1000000000000000000C001
11111111110111111111111
11000000000111000000001
11111111000111000011001
10000000000001000000001
10C00000000001000C0C001
11011100001111000C0C111
10000000000C00000000101
11111111111111111111111
