11111111111111111111111
10000000000000000000001
1000P000000000C000000E1
10000000000000000000001
11111111111111111111111
