1111111111111111111
100000000P000000001
10000000000E00000P1
111C111111111111111
1111111111111111111
