11111111111111111
10000000000000001
1PCE0000000000001
1111111111111111111111111
11111111111111111
