11111111111111111111
100000000000000000E1
00P00000000C00000001
11111111111111111111
